XXXXXXX
S X   X
X XXX X
X   X E
X X X X
X X   X
XXXXXXX